>examine
(Zarb)
A young Ghanrion, his skin faintly luminescent like the forest around him. His wide eyes carry both fear and urgent curiosity. He seems eager to communicate.

>w
Observation Rock
A high cliff with a sweeping view of the entire forest. The bioluminescent canopy stretches endlessly to the east and north. To the WEST, a column of black smoke rises against the sky -- something has crashed on your world.

To the EAST, the path descends back into the forest.

>w
You step out from the treeline toward the wreckage.

A sweep of white searchlight catches you immediately.

"CONTACT -- northeast perimeter!" a soldier shouts.

Boots hammer the ground. You have no time to run, and no ally to protect you.

    *** Captured by Humans -- You approached the crash site alone and were detected. Return to the forest, find Xilar in the Ravine, and free him first. ***

In that game you scored 0 out of a possible 20, in 3 turns.

Would you like to RESTART, RESTORE a saved game, QUIT or UNDO the last command?

>UNDO
Observation Rock
[Previous turn undone.]

>east
Bioluminescent Forest
A vast forest where every plant pulses with soft blue and green light. Bioluminescent spores drift like slow snow between towering trees, and the air hums with quiet, ancient life.

A massive fallen tree blocks the northern path to the Ghanrion Camp. To the EAST the ground drops away toward the Ravine, and to the WEST a rocky path climbs toward the Observation Rock.

You can see Zarb here.

>w
Observation Rock
A high cliff with a sweeping view of the entire forest. The bioluminescent canopy stretches endlessly to the east and north. To the WEST, a column of black smoke rises against the sky -- something has crashed on your world.

To the EAST, the path descends back into the forest.

>n
You can't go that way.

>s
You can't go that way.

>e
Bioluminescent Forest
A vast forest where every plant pulses with soft blue and green light. Bioluminescent spores drift like slow snow between towering trees, and the air hums with quiet, ancient life.

A massive fallen tree blocks the northern path to the Ghanrion Camp. To the EAST the ground drops away toward the Ravine, and to the WEST a rocky path climbs toward the Observation Rock.

You can see Zarb here.

>w
Observation Rock
A high cliff with a sweeping view of the entire forest. The bioluminescent canopy stretches endlessly to the east and north. To the WEST, a column of black smoke rises against the sky -- something has crashed on your world.

To the EAST, the path descends back into the forest.

>w
You step out from the treeline toward the wreckage.

A sweep of white searchlight catches you immediately.

"CONTACT -- northeast perimeter!" a soldier shouts.

Boots hammer the ground. You have no time to run, and no ally to protect you.

    *** Captured by Humans -- You approached the crash site alone and were detected. Return to the forest, find Xilar in the Ravine, and free him first. ***

In that game you scored 0 out of a possible 20, in 9 turns.

Would you like to RESTART, RESTORE a saved game, QUIT or UNDO the last command?

>undo
Observation Rock
[Previous turn undone.]

>e
Bioluminescent Forest
A vast forest where every plant pulses with soft blue and green light. Bioluminescent spores drift like slow snow between towering trees, and the air hums with quiet, ancient life.

A massive fallen tree blocks the northern path to the Ghanrion Camp. To the EAST the ground drops away toward the Ravine, and to the WEST a rocky path climbs toward the Observation Rock.

You can see Zarb here.

>e
Ravine
A deep, rocky ravine. The walls are jagged and the air is cold and damp. Somewhere beneath the fallen debris you can hear faint, pained breathing.

To the WEST the glow of the forest beckons. Below you, darkness hints at underground tunnels -- go DOWN to explore them.

You can see Xilar here.

>go down
Underground Tunnels
Dark tunnels lit by faint glowing plants embedded in the walls. The passages twist and turn but remain navigable. The air smells of earth and something sharp and chemical -- a smell you do not recognise.

The Ravine is above you -- go UP to return.

>go up
Ravine
A deep, rocky ravine. The walls are jagged and the air is cold and damp. Somewhere beneath the fallen debris you can hear faint, pained breathing.

To the WEST the glow of the forest beckons. Below you, darkness hints at underground tunnels -- go DOWN to explore them.

You can see Xilar here.

>talk to Xilar
Xilar winces in pain but holds your gaze with clear, determined eyes.

"The debris... I cannot shift it alone. Free me, and I will lead you past the fallen tree to the camp. The elder must be warned before the humans reach the treeline."

He glances at the rubble pressing down on him.

Type HELP XILAR to attempt to free him.

>help Xilar
You brace yourself and drag the heavy debris aside piece by piece. It takes every ounce of your strength.

Xilar pulls himself free with a sharp exhale, checks his injuries with practised calm, and rises to his feet.

"Thank you," he says simply. "The camp -- now. Follow me back WEST. I know a way around the fallen tree."

The northern path to the Ghanrion Camp is now accessible -- return WEST to the forest, and then go NORTH.

[Your score has just gone up by five points.]

>w
Bioluminescent Forest
A vast forest where every plant pulses with soft blue and green light. Bioluminescent spores drift like slow snow between towering trees, and the air hums with quiet, ancient life.

A massive fallen tree blocks the northern path to the Ghanrion Camp. To the EAST the ground drops away toward the Ravine, and to the WEST a rocky path climbs toward the Observation Rock.

You can see Xilar and Zarb here.

I beg your pardon?

>e
Ravine
A deep, rocky ravine. The walls are jagged and the air is cold and damp. Somewhere beneath the fallen debris you can hear faint, pained breathing.

To the WEST the glow of the forest beckons. Below you, darkness hints at underground tunnels -- go DOWN to explore them.

>back
That's not a verb I recognise.

>go down
Underground Tunnels
Dark tunnels lit by faint glowing plants embedded in the walls. The passages twist and turn but remain navigable. The air smells of earth and something sharp and chemical -- a smell you do not recognise.

The Ravine is above you -- go UP to return.

>examine
What do you want to examine?

>Underground Tunnels
You can't see any such thing.

* * *

>go
You'll have to say which compass direction to go in.

>north
Corridor
A narrow maintenance corridor. Pipes run along the ceiling. You can hear voices to the east, and the hum of the engine room to the west.

>west
Engine Room
Massive turbines roar around you. Your people's bio-energy is being drained to power this machine. You feel their pain.

You can see a control panel here.

>go
You'll have to say which compass direction to go in.

>east
Corridor
A narrow maintenance corridor. Pipes run along the ceiling. You can hear voices to the east, and the hum of the engine room to the west.

>east
You can't go that way.

>south
Prison Cell
You are in a dimly lit cell in the lower decks of the ISS Andromeda. The metal walls are cold and damp. To the north lies a dark corridor.

You can see a rusty pipe here.

>south
You can't go that way.

>west
You can't go that way.

>east
You can't go that way.

>north
Corridor
A narrow maintenance corridor. Pipes run along the ceiling. You can hear voices to the east, and the hum of the engine room to the west.

>east
You can't go that way.

>west
Engine Room
Massive turbines roar around you. Your people's bio-energy is being drained to power this machine. You feel their pain.

You can see a control panel here.

>inspect
That's not a verb I recognise.

>enter
You must supply a noun.

>down
You can't go that way.

>look
Engine Room
Massive turbines roar around you. Your people's bio-energy is being drained to power this machine. You feel their pain.

You can see a control panel here.

>look
Engine Room
Massive turbines roar around you. Your people's bio-energy is being drained to power this machine. You feel their pain.

You can see a control panel here.

>inspect
That's not a verb I recognise.

>search
(the control panel)
You find nothing of interest.

>exit
But you aren't in anything at the moment.

>north
You can't go that way.

>west
You can't go that way.

>east
Corridor
A narrow maintenance corridor. Pipes run along the ceiling. You can hear voices to the east, and the hum of the engine room to the west.

>up
You can't go that way.

>down
You can't go that way.

>north
You can't go that way.

>south
Prison Cell
You are in a dimly lit cell in the lower decks of the ISS Andromeda. The metal walls are cold and damp. To the north lies a dark corridor.

You can see a rusty pipe here.

>search
(the rusty pipe)
You find nothing of interest.

>exit
But you aren't in anything at the moment.

>exit
But you aren't in anything at the moment.

>take
(the rusty pipe)
Taken.

>inventory
You are carrying:
  a rusty pipe

>examine
(the rusty pipe)
A heavy maintenance pipe. Could be useful.

>exit
But you aren't in anything at the moment.

>north
Corridor
A narrow maintenance corridor. Pipes run along the ceiling. You can hear voices to the east, and the hum of the engine room to the west.

>take
(the rusty pipe)
You already have that.

>west
Engine Room
Massive turbines roar around you. Your people's bio-energy is being drained to power this machine. You feel their pain.

You can see a control panel here.

>take
(the control panel)
Taken.

>examine
What do you want to examine?

>control panel
A panel covered in switches and warning lights. One switch is labeled EMERGENCY RELEASE.

>use panel
That's not a verb I recognise.

>use button
That's not a verb I recognise.

>use switch
That's not a verb I recognise.

>switch
What do you want to switch?

>EMERGENCY RELEASE
You can't see any such thing.

>EMERGENCY RELEASE.
That's not a verb I recognise.

I beg your pardon?

>EMERGENCY RELEASE
That's not a verb I recognise.

I beg your pardon?

I beg your pardon?

>exit
But you aren't in anything at the moment.

* * *

>go e
Ravine
A deep natural ravine carved into warm, mineral-rich rock.

You can see Xilar here.

>go e
You can't go that way.

>go down
Underground Tunnels
Natural tunnels illuminated by faint bioluminescent flora.

You can see a Bioluminescent Plant here.

You enter the underground tunnels illuminated by natural bioluminescent life.

>go up
Ghanrion Camp
A peaceful tribal settlement built among living vegetation.

You can see Vael here.

You emerge near the camp.

Human forces have surrounded the camp. Elder Vael stands before their commander. You must decide quickly: act, guide, or observe.

>help vael
You cannot make that decision here.

>choose help vael
That's not a verb I recognise.

>go s
Bioluminescent Forest
A vast glowing forest where bioluminescent plants illuminate the silence. The world feels peaceful and untouched. You must explore de world around you. Or you can just stay freeze and don't play this awsome text adventure

You can see Zarb here.

>go w
Observation Rock
A high rocky ledge overlooking the forest and distant open terrain.

>w
There is nothing there yet.

>script off
Transcripting is already off.

* * *

>go north
The fallen tree blocks the path. You must find another route.

>go west
Observation Rock
A high rocky ledge overlooking the forest and distant open terrain.

>look
Observation Rock
A high rocky ledge overlooking the forest and distant open terrain.

>take
What do you want to take?

>rock
You can't see any such thing.

>go
You'll have to say which compass direction to go in.

>go east
Bioluminescent Forest
A vast glowing forest where bioluminescent plants illuminate the silence. The world feels peaceful and untouched.

You can see Zarb here.

>go south
You can't go that way.

>go north
The fallen tree blocks the path. You must find another route.

* * *

>go west
Observation Rock
A high rocky ledge overlooking the forest and distant open terrain.

>help xilar
You free Xilar. He is injured but follows you.

>observe
You cannot make that decision here.

>observe
You cannot make that decision here.

>test me
>--> No test scripts exist for this game.

>rules
Rules tracing now switched on. Type "rules off" to switch it off again, or "rules all" to include even rules which do not apply.

>rules all
[Rule "declare everything initially unmentioned rule" applies.]
Rules tracing now switched to "all". Type "rules off" to switch it off again.

* * *

>go north
The fallen tree blocks the path. You must find another route.

>examine
(Zarb)
You are Zarb. You can sense emotional signals from others through weak telepathy.

>examine fallen tree
A massive fallen tree blocks the direct path toward the camp.

>go s
You can't go that way.

>go w
Observation Rock
A high rocky ledge overlooking the forest and distant open terrain.

>go east
Bioluminescent Forest
A vast glowing forest where bioluminescent plants illuminate the silence. The world feels peaceful and untouched. You must explore de world around you. Or you can just stay freeze and don't play this awsome text adventure

You can see Zarb here.

>examine bioluminescent forest
You can't see any such thing.

>examine bioluminescent plant
You can't see any such thing.

>examine bioluminescent plant
You can't see any such thing.

>x Zarb
You are Zarb. You can sense emotional signals from others through weak telepathy.

>w
Observation Rock
A high rocky ledge overlooking the forest and distant open terrain.

>w
There is nothing there yet.

>w
There is nothing there yet.

>s
You can't go that way.

>s
You can't go that way.

>n
You can't go that way.

>n
You can't go that way.

>e
Bioluminescent Forest
A vast glowing forest where bioluminescent plants illuminate the silence. The world feels peaceful and untouched. You must explore de world around you. Or you can just stay freeze and don't play this awsome text adventure

You can see Zarb here.

>e
Ravine
A deep natural ravine carved into warm, mineral-rich rock.

You can see Xilar here.

>see xilar
That's not a verb I recognise.

>talk to xilar
That's not a verb I recognise.

>help xilar
You free Xilar. He is injured but follows you.

>w
Bioluminescent Forest
A vast glowing forest where bioluminescent plants illuminate the silence. The world feels peaceful and untouched. You must explore de world around you. Or you can just stay freeze and don't play this awsome text adventure

You can see Xilar and Zarb here.

>e
Ravine
A deep natural ravine carved into warm, mineral-rich rock.

>s
You can't go that way.

* * *

>look
Bioluminescent Forest
A vast glowing forest where bioluminescent plants illuminate the silence. The world feels peaceful and untouched.

You can see Zarb here.

>north
The fallen tree blocks the path. You must find another route.

>south
You can't go that way.

>change route
That's not a verb I recognise.

>west
Observation Rock
A high rocky ledge overlooking the forest and distant open terrain.

>look
Observation Rock
A high rocky ledge overlooking the forest and distant open terrain.

>south
You can't go that way.

>wes
That's not a verb I recognise.

>west
There is nothing there yet.

>east
Bioluminescent Forest
A vast glowing forest where bioluminescent plants illuminate the silence. The world feels peaceful and untouched.

You can see Zarb here.

>talk to Zarb
That's not a verb I recognise.

>search
(Zarb)
You find nothing of interest.

>north
The fallen tree blocks the path. You must find another route.

>west
Observation Rock
A high rocky ledge overlooking the forest and distant open terrain.

>north
You can't go that way.

>south
You can't go that way.

>west
There is nothing there yet.

* * *

>east
Bioluminescent Forest
A vast glowing forest where bioluminescent plants illuminate the silence. The world feels peaceful and untouched.

You can see Zarb here.

>west
Observation Rock
A high rocky ledge overlooking the forest and distant open terrain.

>walk
You'll have to say which compass direction to go in.

>search
What do you want to search?

>path
You can't see any such thing.

>human
That's not a verb I recognise.

>search human
You can't see any such thing.

* * *

>look
Bioluminescent Forest
A vast glowing forest where bioluminescent plants illuminate the silence. The world feels peaceful and untouched.

You can see Zarb here.

>talk
That's not a verb I recognise.

>go there
You can't see any such thing.

>go north
The fallen tree blocks the path. You must find another route.

>help Zarb
I didn't understand that sentence.

* * *

>look map
============================================================

               WORLD MAP: THE GHANRION FOREST               

============================================================

      <Ghanrion Camp>  GHANRION CAMP

             |

           NORTH

             | (blocked until Xilar is freed)

             |

(Human Crash) -- WEST -- (Observation) -- EAST -- (Bioluminescent) -- EAST -- (Ravine)

(Crash Site )            (   Rock    )            (    Forest    )            

                                                                                |

                                                                              DOWN

                                                                                |

                                                                      (Underground Tunnels)

--- LOCATION GUIDE ---

BIOLUMINESCENT FOREST  <-- YOU ARE HERE

  The central hub of the map. Your starting location and the heart

  of the Ghanrion world. NPC: Zarb (young Ghanrion scout).

  Exits: EAST (Ravine), WEST (Observation Rock), NORTH (Ghanrion Camp)

THE RAVINE

  East of the Bioluminescent Forest. A deep rocky ravine.

  NPC: Xilar (trapped Ghanrion warrior). Key action: HELP XILAR.

  Exits: WEST (Bioluminescent Forest), DOWN (Underground Tunnels)

UNDERGROUND TUNNELS

  Beneath the Ravine. Dark passages lit by bioluminescent plants.

  A hidden escape route used in the final sequence.

  Exits: UP (The Ravine)

OBSERVATION ROCK

  West of the Bioluminescent Forest. A high vantage point.

  The smoke of the crash site is visible from here.

  Exits: EAST (Bioluminescent Forest), WEST (Human Crash Site -- DANGEROUS)

HUMAN CRASH SITE

  West of Observation Rock. A burning crash site with armed human soldiers.

  WARNING: Entering without Xilar's help ends the game. NPC: Captain Jack.

  Exits: EAST (Observation Rock)

GHANRION CAMP

  North of the Bioluminescent Forest. The final destination.

  LOCKED until you free Xilar in the Ravine. NPC: Vael (elder).

  Warning: Arriving triggers the Camp Siege finale.

  Exits: SOUTH (Bioluminescent Forest)

--- RECOMMENDED PATH ---

  1. Talk to Zarb (Bioluminescent Forest)

  2. Go EAST -- Ravine -- free Xilar (HELP XILAR)

  3. Explore freely. Try USE TELEPATHY

  4. Go WEST then WEST -- visit Observation Rock and the Crash Site

  5. Return and go NORTH -- Ghanrion Camp -- face the finale

============================================================

* * *

>script on
Start of a transcript of:

Before Andromeda: The Sky Breaks
Episode 1 - The Sky Breaks by Saturnio Games
Release 1 / Serial number 260525 / Inform 7 v10.1.2 / D
Inform 7 v10.1.2
Identification number: //50F114AA-42D1-492E-B1B0-3EEB5077581A//
Interpreter version 0.6.1 / VM 3.1.3

>freeze
That's not a verb I recognise.

>talk to Zarb
That's not a verb I recognise.

>talk Zarb
That's not a verb I recognise.

>examine Zarb
You are Zarb. You can sense emotional signals from others through weak telepathy.

>go s
You can't go that way.

>go n
The fallen tree blocks the path. You must find another route.

>destroy fallen tree~
I only understood you as far as wanting to destroy the Fallen Tree.

>destroy fallen tree
Violence isn't the answer to this one.

>jump over fallen tree
I only understood you as far as wanting to jump.

>jump fallen tree
I only understood you as far as wanting to jump.

>jump
You jump on the spot.

>go e
Ravine
A deep natural ravine carved into warm, mineral-rich rock.

You can see Xilar here.

>examine xilar
A young Ghanrion trapped under a broken branch.

>talk to xilar
That's not a verb I recognise.

>talk xilar
That's not a verb I recognise.

>speak to xilar
I didn't understand that sentence.

>lift broken branch
That's not a verb I recognise.

>examine broken branch
You can't see any such thing.

>save xilar
I only understood you as far as wanting to save.

>rescue xilar
That's not a verb I recognise.

>take xilar
I don't suppose Xilar would care for that.

>help xilar
You free Xilar. He is injured but follows you.

>go e
You can't go that way.

>go n
You can't go that way.

>go s
You can't go that way.

>go w
Bioluminescent Forest
A vast glowing forest where bioluminescent plants illuminate the silence. The world feels peaceful and untouched. You must explore de world around you. Or you can just stay freeze and don't play this awsome text adventure

You can see Xilar and Zarb here.

>go n
The fallen tree blocks the path. You must find another route.

>use xilar
That's not a verb I recognise.

>throw xilar at fallen tree
(first taking Xilar)
I don't suppose Xilar would care for that.

>go w
Observation Rock
A high rocky ledge overlooking the forest and distant open terrain.

>examine high rocky ledge
You can't see any such thing.

>go w
There is nothing there yet.

>go n
You can't go that way.

* * *

>go s
You can't go that way.

>examine distant open terrain
You can't see any such thing.

>examine forest
You can't see any such thing.

>jump
You jump on the spot.

>dance
That's not a verb I recognise.

>go e
Bioluminescent Forest
A vast glowing forest where bioluminescent plants illuminate the silence. The world feels peaceful and untouched. You must explore de world around you. Or you can just stay freeze and don't play this awsome text adventure

You can see Xilar and Zarb here.

>go e
Ravine
A deep natural ravine carved into warm, mineral-rich rock.

>go below
You can't see any such thing.

>go inside
You can't go that way.

>go down
Underground Tunnels
Natural tunnels illuminated by faint bioluminescent flora.

You can see a Bioluminescent Plant here.

You enter the underground tunnels illuminated by natural bioluminescent life.

>examine plant~
You can't see any such thing.

>examine plant
A small plant emitting soft blue light.

>go inside
You can't go that way.

>go e
You can't go that way.

>go w
You can't go that way.

>go n
You can't go that way.

>g s
You can't go that way.

>go up
Ghanrion Camp
A peaceful tribal settlement built among living vegetation.

You can see Vael here.

You emerge near the camp.

Human forces have surrounded the camp. Elder Vael stands before their commander. You must decide quickly: act, guide, or observe.

>examine vael
The elder of the tribe, calm and respected.

>take vael
I don't suppose Vael would care for that.

>observe
You cannot make that decision here.

>act
That's not a verb I recognise.

>guide
I didn't understand that sentence.

>decide act
That's not a verb I recognise.

>help vael
You cannot make that decision here.

>exit
But you aren't in anything at the moment.

>go n
You can't go that way.

>go e
You can't go that way.

>go down
You can't go that way.

>go up
You can't go that way.

>go s
Bioluminescent Forest
A vast glowing forest where bioluminescent plants illuminate the silence. The world feels peaceful and untouched. You must explore de world around you. Or you can just stay freeze and don't play this awsome text adventure

You can see Xilar and Zarb here.

>go n
The fallen tree blocks the path. You must find another route.

>go e
Ravine
A deep natural ravine carved into warm, mineral-rich rock.

>go down
Underground Tunnels
Natural tunnels illuminated by faint bioluminescent flora.

You can see a Bioluminescent Plant here.

You enter the underground tunnels illuminated by natural bioluminescent life.

>go up
Ghanrion Camp
A peaceful tribal settlement built among living vegetation.

You can see Vael here.

You emerge near the camp.

>help vael
You cannot make that decision here.

* * *

>script on
Start of a transcript of:

Before Andromeda: The Sky Breaks
Episode 1 - The Sky Breaks by Saturnio Games
Release 1 / Serial number 260525 / Inform 7 v10.1.2 / D
Inform 7 v10.1.2
Identification number: //50F114AA-42D1-492E-B1B0-3EEB5077581A//
Interpreter version 0.6.1 / VM 3.1.3

>script off
Transcripting is already off.

* * *

>script on
Start of a transcript of:

Before Andromeda: The Sky Breaks
Episode 1 - The Sky Breaks by Saturnio Games
Release 1 / Serial number 260525 / Inform 7 v10.1.2 / D
Inform 7 v10.1.2
Identification number: //50F114AA-42D1-492E-B1B0-3EEB5077581A//
Interpreter version 0.6.1 / VM 3.1.3

>talk to zarb
Zarb communicates through a series of soft bioluminescent pulses and deliberate gestures. Somehow, you understand every word.

"Something fell from the sky -- to the west. It burns, and it brought soldiers with it. They will push deeper into the forest. We must warn the camp, but the elder will not act on my word alone. Xilar carries the elder's trust."

He pauses, his skin flickering with anxious light.

"Xilar was scouting the Ravine when the debris came down on him. Please -- free him first. Go EAST to find him. Type HELP XILAR when you reach him."

>use telepathy
You close your eyes and push a weak telepathic signal outward through the forest network.

For a moment, nothing. Then a tremor moves through the bioluminescent light all around you -- the plants respond like a living relay, carrying your signal through root and spore and branch.

Zarb spins toward you, eyes wide.

"You... you sent that?" His skin flashes bright white with shock.

The forest hums softly in reply.

[Your score has just gone up by two points.]

>g
You have already sent the signal. A faint mental echo still lingers at the edge of your awareness.

>e
Ravine
A deep, rocky ravine. The walls are jagged and the air is cold and damp. Somewhere beneath the fallen debris you can hear faint, pained breathing.

To the WEST the glow of the forest beckons. Below you, darkness hints at underground tunnels -- go DOWN to explore them.

You can see Xilar here.

>use telepathy
You have already sent the signal. A faint mental echo still lingers at the edge of your awareness.

>talk to xilar
Xilar winces in pain but holds your gaze with clear, determined eyes.

"The debris... I cannot shift it alone. Free me, and I will lead you past the fallen tree to the camp. The elder must be warned before the humans reach the treeline."

He glances at the rubble pressing down on him.

Type HELP XILAR to attempt to free him.

>help xilar
You brace yourself and drag the heavy debris aside piece by piece. It takes every ounce of your strength.

Xilar pulls himself free with a sharp exhale, checks his injuries with practised calm, and rises to his feet.

"Thank you," he says simply. "The camp -- now. Follow me back WEST. I know a way around the fallen tree."

The northern path to the Ghanrion Camp is now accessible -- return WEST to the forest, and then go NORTH.

[Your score has just gone up by five points.]

>talk to xilar
You can't see any such thing.

>w
Bioluminescent Forest
A vast forest where every plant pulses with soft blue and green light. Bioluminescent spores drift like slow snow between towering trees, and the air hums with quiet, ancient life.

A massive fallen tree blocks the northern path to the Ghanrion Camp. To the EAST the ground drops away toward the Ravine, and to the WEST a rocky path climbs toward the Observation Rock.

You can see Xilar and Zarb here.

>talk to xilar
Xilar nods with quiet, steady gratitude.

"I owe you a debt I will not forget. These forests hold no secrets from me. The fallen tree across the north path is no obstacle -- I know every hidden trail. Walk with me and I will guide you safely to the camp."

He glances north. "You can go NORTH now from the forest."

>use telepathy
You have already sent the signal. A faint mental echo still lingers at the edge of your awareness.

>n
Ghanrion Camp
A living settlement woven among ancient trees. Bioluminescent lanterns sway between branches, casting the settlement in warm, shifting light. The elder Vael moves with quiet authority between the shelters.

To the SOUTH lies the Bioluminescent Forest.

You can see Vael here.

The moment you arrive at the camp, the ground shakes with the deep percussion of approaching footsteps.

Human soldiers emerge from the southern treeline, weapons raised, visors reflecting the bioluminescent light. The entire camp falls utterly silent.

Vael steps forward alone. His arms are wide, his palms open. His voice is very low.

"They are afraid. And fear, more than hatred, makes them dangerous."

He turns to you.

"What will you do?"

You have three choices:

  HELP VAEL -- Step forward and stand beside the elder.

  GUIDE YOUNG -- Lead the children and elders through the underground tunnels to safety.

  OBSERVE -- Pull back into the shadows and bear witness.

[Your score has just gone up by five points.]

>observe
You step back into the deep shadow of the trees and become very still.

Vael speaks to the soldiers in slow, measured tones. They cannot understand his words, but his absolute calm is a language of its own -- one that transcends species and training and fear.

The standoff holds. Neither side advances. Neither side fires.

Hours pass. Eventually the soldiers withdraw toward the crash site. Vael watches them go, unmoving, until the last footstep fades.

He does not look for you. But as he finally turns back toward the camp, you have the quiet sense that he always knew you were there.

You wonder, in the long silence that follows, what your presence beside him might have changed.

    *** The Silent Witness -- You watched, but did not act. Some choices are made by not choosing. The forest will remember. ***

In that game you scored 12 out of a possible 20, in 12 turns.

Would you like to RESTART, RESTORE a saved game, QUIT or UNDO the last command?

>undo
Ghanrion Camp
[Previous turn undone.]

>help vael
You walk forward and stand beside Vael.

The soldiers freeze.

Something about the image -- the ancient elder and a being they cannot categorise, standing together without weapons, without aggression, without fear -- fractures their certainty. Training accounts for hostility. It does not account for this.

A long silence stretches across the camp. The wind moves through the luminescent leaves.

Slowly, one soldier lowers his weapon. Then another. Then all of them.

Vael places a hand on your shoulder and says nothing. He does not need to.

Behind you, the camp exhales.

    *** A Fragile Peace -- You stood with the Ghanrion and turned fear into stillness. The first step toward understanding has been taken. ***

In that game you scored 17 out of a possible 20, in 12 turns.

Would you like to RESTART, RESTORE a saved game, QUIT or UNDO the last command?

>undo
Ghanrion Camp
[Previous turn undone.]

>guide young
You move quickly and without a word, gathering the young Ghanrion with calm, urgent gestures. Through the tunnels beneath the Ravine -- tunnels you now know well -- you lead them in single file through the glowing dark.

Behind you, voices rise. Tense and confused. But no pursuit comes.

The children emerge into the far forest, blinking in the cold air. One of the youngest looks back at you, her luminescent eyes wide and full of something that might be gratitude, or wonder, or both.

Above ground, the standoff continues. You have saved some. The rest remains unwritten.

    *** Partial Escape -- The young were saved. The fate of the camp is still unwritten. Perhaps that is enough for now. ***

In that game you scored 15 out of a possible 20, in 12 turns.

Would you like to RESTART, RESTORE a saved game, QUIT or UNDO the last command?

>undo
Ghanrion Camp
[Previous turn undone.]

>s
Bioluminescent Forest
A vast forest where every plant pulses with soft blue and green light. Bioluminescent spores drift like slow snow between towering trees, and the air hums with quiet, ancient life.

A massive fallen tree blocks the northern path to the Ghanrion Camp. To the EAST the ground drops away toward the Ravine, and to the WEST a rocky path climbs toward the Observation Rock.

You can see Xilar and Zarb here.

>w
Observation Rock
A high cliff with a sweeping view of the entire forest. The bioluminescent canopy stretches endlessly to the east and north. To the WEST, a column of black smoke rises against the sky -- something has crashed on your world.

To the EAST, the path descends back into the forest.

>e
Bioluminescent Forest
A vast forest where every plant pulses with soft blue and green light. Bioluminescent spores drift like slow snow between towering trees, and the air hums with quiet, ancient life.

A massive fallen tree blocks the northern path to the Ghanrion Camp. To the EAST the ground drops away toward the Ravine, and to the WEST a rocky path climbs toward the Observation Rock.

You can see Xilar and Zarb here.

>w
Observation Rock
A high cliff with a sweeping view of the entire forest. The bioluminescent canopy stretches endlessly to the east and north. To the WEST, a column of black smoke rises against the sky -- something has crashed on your world.

To the EAST, the path descends back into the forest.

>w
You move toward the open ridge, but before you can step into the light, Xilar's hand closes firmly around your arm.

"Not yet. They are still searching the crash site. If they see us now, they will follow us straight back to the camp."

He draws you back into the shadow of the rocks. You return to the Observation Rock.

[Your score has just gone up by three points.]

>e
Bioluminescent Forest
A vast forest where every plant pulses with soft blue and green light. Bioluminescent spores drift like slow snow between towering trees, and the air hums with quiet, ancient life.

A massive fallen tree blocks the northern path to the Ghanrion Camp. To the EAST the ground drops away toward the Ravine, and to the WEST a rocky path climbs toward the Observation Rock.

You can see Xilar and Zarb here.

>n
Ghanrion Camp
A living settlement woven among ancient trees. Bioluminescent lanterns sway between branches, casting the settlement in warm, shifting light. The elder Vael moves with quiet authority between the shelters.

To the SOUTH lies the Bioluminescent Forest.

You can see Vael here.

>help vael
You walk forward and stand beside Vael.

The soldiers freeze.

Something about the image -- the ancient elder and a being they cannot categorise, standing together without weapons, without aggression, without fear -- fractures their certainty. Training accounts for hostility. It does not account for this.

A long silence stretches across the camp. The wind moves through the luminescent leaves.

Slowly, one soldier lowers his weapon. Then another. Then all of them.

Vael places a hand on your shoulder and says nothing. He does not need to.

Behind you, the camp exhales.

    *** A Fragile Peace -- You stood with the Ghanrion and turned fear into stillness. The first step toward understanding has been taken. ***

In that game you scored 20 out of a possible 20, in 19 turns.

Would you like to RESTART, RESTORE a saved game, QUIT or UNDO the last command?

>undo
Ghanrion Camp
[Previous turn undone.]

* * *

>w
You move toward the open ridge, but before you can step into the light, Xilar's hand closes firmly around your arm.

"Not yet. They are still searching the crash site. If they see us now, they will follow us straight back to the camp."

He draws you back into the shadow of the rocks. You return to the Observation Rock.

[Your score has just gone up by three points.]

>w
You move toward the open ridge, but before you can step into the light, Xilar's hand closes firmly around your arm.

"Not yet. They are still searching the crash site. If they see us now, they will follow us straight back to the camp."

He draws you back into the shadow of the rocks. You return to the Observation Rock.

[Your score has just gone up by three points.]

I beg your pardon?

>w
You move toward the open ridge, but before you can step into the light, Xilar's hand closes firmly around your arm.

"Not yet. They are still searching the crash site. If they see us now, they will follow us straight back to the camp."

He draws you back into the shadow of the rocks. You return to the Observation Rock.

[Your score has just gone up by three points.]

>g
You move toward the open ridge, but before you can step into the light, Xilar's hand closes firmly around your arm.

"Not yet. They are still searching the crash site. If they see us now, they will follow us straight back to the camp."

He draws you back into the shadow of the rocks. You return to the Observation Rock.

[Your score has just gone up by three points.]

>g
You move toward the open ridge, but before you can step into the light, Xilar's hand closes firmly around your arm.

"Not yet. They are still searching the crash site. If they see us now, they will follow us straight back to the camp."

He draws you back into the shadow of the rocks. You return to the Observation Rock.

[Your score has just gone up by three points.]

I beg your pardon?

>g
You move toward the open ridge, but before you can step into the light, Xilar's hand closes firmly around your arm.

"Not yet. They are still searching the crash site. If they see us now, they will follow us straight back to the camp."

He draws you back into the shadow of the rocks. You return to the Observation Rock.

[Your score has just gone up by three points.]

>e
Bioluminescent Forest
A vast forest where every plant pulses with soft blue and green light. Bioluminescent spores drift like slow snow between towering trees, and the air hums with quiet, ancient life.

A massive fallen tree blocks the northern path to the Ghanrion Camp. To the EAST the ground drops away toward the Ravine, and to the WEST a rocky path climbs toward the Observation Rock.

You can see Xilar and Zarb here.

* * *

>w
Observation Rock
A high cliff with a sweeping view of the entire forest. The bioluminescent canopy stretches endlessly to the east and north. To the WEST, a column of black smoke rises against the sky -- something has crashed on your world.

To the EAST, the path descends back into the forest.

>help vael
You can't see any such thing.

>help zael
You can't see any such thing.

>observe
You step back into the deep shadow of the trees and become very still.

Vael speaks to the soldiers in slow, measured tones. They cannot understand his words, but his absolute calm is a language of its own -- one that transcends species and training and fear.

The standoff holds. Neither side advances. Neither side fires.

Hours pass. Eventually the soldiers withdraw toward the crash site. Vael watches them go, unmoving, until the last footstep fades.

He does not look for you. But as he finally turns back toward the camp, you have the quiet sense that he always knew you were there.

You wonder, in the long silence that follows, what your presence beside him might have changed.

    *** The Silent Witness -- You watched, but did not act. Some choices are made by not choosing. The forest will remember. ***

In that game you scored 99 out of a possible 20, in 51 turns.

Would you like to RESTART, RESTORE a saved game, QUIT or UNDO the last command?

>script off
Please give one of the answers above.

Would you like to RESTART, RESTORE a saved game, QUIT or UNDO the last command?

* * *

>show me
(Zarb)
(first taking Zarb)
I don't suppose Zarb would care for that.

>take
(Zarb)
I don't suppose Zarb would care for that.

>look
Bioluminescent Forest
A vast glowing forest where bioluminescent plants illuminate the silence. The world feels peaceful and untouched.

You can see Zarb here.

>get
(Zarb)
I don't suppose Zarb would care for that.

>i
You are carrying nothing.

>drop
(Zarb)
Zarb is already here.

>talk to Zarb
That's not a verb I recognise.

>help
I didn't understand that sentence.

>read
(Zarb)
You are Zarb. You can sense emotional signals from others through weak telepathy.

* * *

>talk
That's not a verb I recognise.

>see
That's not a verb I recognise.

>aproach
That's not a verb I recognise.

* * *

>talk to Zarb
Zarb communicates through a series of soft bioluminescent pulses and deliberate gestures. Somehow, you understand every word.

"Something fell from the sky -- to the west. It burns, and it brought soldiers with it. They will push deeper into the forest. We must warn the camp, but the elder will not act on my word alone. Xilar carries the elder's trust."

He pauses, his skin flickering with anxious light.

"Xilar was scouting the Ravine when the debris came down on him. Please -- free him first. Go EAST to find him. Type HELP XILAR when you reach him."

>e
Ravine
A deep, rocky ravine. The walls are jagged and the air is cold and damp. Somewhere beneath the fallen debris you can hear faint, pained breathing.

To the WEST the glow of the forest beckons. Below you, darkness hints at underground tunnels -- go DOWN to explore them.

You can see Xilar here.

>talk to xilar
Xilar winces in pain but holds your gaze with clear, determined eyes.

"The debris... I cannot shift it alone. Free me, and I will lead you past the fallen tree to the camp. The elder must be warned before the humans reach the treeline."

He glances at the rubble pressing down on him.

Type HELP XILAR to attempt to free him.

* * *

>help xilar
You brace yourself and drag the heavy debris aside piece by piece. It takes every ounce of your strength.

Xilar pulls himself free with a sharp exhale, checks his injuries with practised calm, and rises to his feet.

"Thank you," he says simply. "The camp -- now. Follow me back WEST. I know a way around the fallen tree."

The northern path to the Ghanrion Camp is now accessible -- return WEST to the forest, and then go NORTH.

[Your score has just gone up by five points.]

>w
Bioluminescent Forest
A vast forest where every plant pulses with soft blue and green light. Bioluminescent spores drift like slow snow between towering trees, and the air hums with quiet, ancient life.

A massive fallen tree blocks the northern path to the Ghanrion Camp. To the EAST the ground drops away toward the Ravine, and to the WEST a rocky path climbs toward the Observation Rock.

You can see Xilar and Zarb here.

>e
Ravine
A deep, rocky ravine. The walls are jagged and the air is cold and damp. Somewhere beneath the fallen debris you can hear faint, pained breathing.

To the WEST the glow of the forest beckons. Below you, darkness hints at underground tunnels -- go DOWN to explore them.

>w
Bioluminescent Forest
A vast forest where every plant pulses with soft blue and green light. Bioluminescent spores drift like slow snow between towering trees, and the air hums with quiet, ancient life.

A massive fallen tree blocks the northern path to the Ghanrion Camp. To the EAST the ground drops away toward the Ravine, and to the WEST a rocky path climbs toward the Observation Rock.

You can see Xilar and Zarb here.

* * *

>e
Ravine
A deep, rocky ravine. The walls are jagged and the air is cold and damp. Somewhere beneath the fallen debris you can hear faint, pained breathing.

To the WEST the glow of the forest beckons. Below you, darkness hints at underground tunnels -- go DOWN to explore them.

>down
Underground Tunnels
Dark tunnels lit by faint glowing plants embedded in the walls. The passages twist and turn but remain navigable. The air smells of earth and something sharp and chemical -- a smell you do not recognise.

The Ravine is above you -- go UP to return.

>explore
That's not a verb I recognise.

>search
What do you want to search?

>Tunnels
You can't see any such thing.

>n
You can't go that way.

* * *

>s
You can't go that way.

>w
You can't go that way.

>e
You can't go that way.

>up
Ravine
A deep, rocky ravine. The walls are jagged and the air is cold and damp. Somewhere beneath the fallen debris you can hear faint, pained breathing.

To the WEST the glow of the forest beckons. Below you, darkness hints at underground tunnels -- go DOWN to explore them.

>w
Bioluminescent Forest
A vast forest where every plant pulses with soft blue and green light. Bioluminescent spores drift like slow snow between towering trees, and the air hums with quiet, ancient life.

A massive fallen tree blocks the northern path to the Ghanrion Camp. To the EAST the ground drops away toward the Ravine, and to the WEST a rocky path climbs toward the Observation Rock.

You can see Xilar and Zarb here.

>w
Observation Rock
A high cliff with a sweeping view of the entire forest. The bioluminescent canopy stretches endlessly to the east and north. To the WEST, a column of black smoke rises against the sky -- something has crashed on your world.

To the EAST, the path descends back into the forest.

* * *

>w
You move toward the open ridge, but before you can step into the light, Xilar's hand closes firmly around your arm.

"Not yet. They are still searching the crash site. If they see us now, they will follow us straight back to the camp."

He draws you back into the shadow of the rocks. You return to the Observation Rock.

[Your score has just gone up by three points.]

>return
That's not a verb I recognise.

>w
You move toward the open ridge, but before you can step into the light, Xilar's hand closes firmly around your arm.

"Not yet. They are still searching the crash site. If they see us now, they will follow us straight back to the camp."

He draws you back into the shadow of the rocks. You return to the Observation Rock.

[Your score has just gone up by three points.]

* * *

>e
Bioluminescent Forest
A vast forest where every plant pulses with soft blue and green light. Bioluminescent spores drift like slow snow between towering trees, and the air hums with quiet, ancient life.

A massive fallen tree blocks the northern path to the Ghanrion Camp. To the EAST the ground drops away toward the Ravine, and to the WEST a rocky path climbs toward the Observation Rock.

You can see Xilar and Zarb here.

>s
You can't go that way.

>n
Ghanrion Camp
A living settlement woven among ancient trees. Bioluminescent lanterns sway between branches, casting the settlement in warm, shifting light. The elder Vael moves with quiet authority between the shelters.

To the SOUTH lies the Bioluminescent Forest.

You can see Vael here.

The moment you arrive at the camp, the ground shakes with the deep percussion of approaching footsteps.

Human soldiers emerge from the southern treeline, weapons raised, visors reflecting the bioluminescent light. The entire camp falls utterly silent.

Vael steps forward alone. His arms are wide, his palms open. His voice is very low.

"They are afraid. And fear, more than hatred, makes them dangerous."

He turns to you.

"What will you do?"

You have three choices:

  HELP VAEL -- Step forward and stand beside the elder.

  GUIDE YOUNG -- Lead the children and elders through the underground tunnels to safety.

  OBSERVE -- Pull back into the shadows and bear witness.

[Your score has just gone up by five points.]

>observe
You step back into the deep shadow of the trees and become very still.

Vael speaks to the soldiers in slow, measured tones. They cannot understand his words, but his absolute calm is a language of its own -- one that transcends species and training and fear.

The standoff holds. Neither side advances. Neither side fires.

Hours pass. Eventually the soldiers withdraw toward the crash site. Vael watches them go, unmoving, until the last footstep fades.

He does not look for you. But as he finally turns back toward the camp, you have the quiet sense that he always knew you were there.

You wonder, in the long silence that follows, what your presence beside him might have changed.

    *** The Silent Witness -- You watched, but did not act. Some choices are made by not choosing. The forest will remember. ***

In that game you scored 37 out of a possible 20, in 29 turns.

Would you like to RESTART, RESTORE a saved game, QUIT or UNDO the last command?

* * *

>talk to zarb
Zarb communicates through a series of soft bioluminescent pulses and deliberate gestures. Somehow, you understand every word.

"Something fell from the sky -- to the west. It burns, and it brought soldiers with it. They will push deeper into the forest. We must warn the camp, but the elder will not act on my word alone. Xilar carries the elder's trust."

He pauses, his skin flickering with anxious light.

"Xilar was scouting the Ravine when the debris came down on him. Please -- free him first. Go EAST to find him. Type HELP XILAR when you reach him."

>help xilar
You can't see any such thing.

>e
Ravine
A deep, rocky ravine. The walls are jagged and the air is cold and damp. Somewhere beneath the fallen debris you can hear faint, pained breathing.

To the WEST the glow of the forest beckons. Below you, darkness hints at underground tunnels -- go DOWN to explore them.

You can see Xilar here.

>help xilar
You brace yourself and drag the heavy debris aside piece by piece. It takes every ounce of your strength.

Xilar pulls himself free with a sharp exhale, checks his injuries with practised calm, and rises to his feet.

"Thank you," he says simply. "The camp -- now. Follow me back WEST. I know a way around the fallen tree."

The northern path to the Ghanrion Camp is now accessible -- return WEST to the forest, and then go NORTH.

[Your score has just gone up by five points.]

* * *

>w
Bioluminescent Forest
A vast forest where every plant pulses with soft blue and green light. Bioluminescent spores drift like slow snow between towering trees, and the air hums with quiet, ancient life.

A massive fallen tree blocks the northern path to the Ghanrion Camp. To the EAST the ground drops away toward the Ravine, and to the WEST a rocky path climbs toward the Observation Rock.

You can see Xilar and Zarb here.

>n
Ghanrion Camp
A living settlement woven among ancient trees. Bioluminescent lanterns sway between branches, casting the settlement in warm, shifting light. The elder Vael moves with quiet authority between the shelters.

To the SOUTH lies the Bioluminescent Forest.

You can see Vael here.

The moment you arrive at the camp, the ground shakes with the deep percussion of approaching footsteps.

Human soldiers emerge from the southern treeline, weapons raised, visors reflecting the bioluminescent light. The entire camp falls utterly silent.

Vael steps forward alone. His arms are wide, his palms open. His voice is very low.

"They are afraid. And fear, more than hatred, makes them dangerous."

He turns to you.

"What will you do?"

You have three choices:

  HELP VAEL -- Step forward and stand beside the elder.

  GUIDE YOUNG -- Lead the children and elders through the underground tunnels to safety.

  OBSERVE -- Pull back into the shadows and bear witness.

[Your score has just gone up by five points.]

>help vael
You walk forward and stand beside Vael.

The soldiers freeze.

Something about the image -- the ancient elder and a being they cannot categorise, standing together without weapons, without aggression, without fear -- fractures their certainty. Training accounts for hostility. It does not account for this.

A long silence stretches across the camp. The wind moves through the luminescent leaves.

Slowly, one soldier lowers his weapon. Then another. Then all of them.

Vael places a hand on your shoulder and says nothing. He does not need to.

Behind you, the camp exhales.

    *** A Fragile Peace -- You stood with the Ghanrion and turned fear into stillness. The first step toward understanding has been taken. ***

In that game you scored 15 out of a possible 20, in 6 turns.

Would you like to RESTART, RESTORE a saved game, QUIT or UNDO the last command?

>undo
Ghanrion Camp
[Previous turn undone.]

>w
You can't go that way.

>w
You can't go that way.

>s
Bioluminescent Forest
A vast forest where every plant pulses with soft blue and green light. Bioluminescent spores drift like slow snow between towering trees, and the air hums with quiet, ancient life.

A massive fallen tree blocks the northern path to the Ghanrion Camp. To the EAST the ground drops away toward the Ravine, and to the WEST a rocky path climbs toward the Observation Rock.

You can see Xilar and Zarb here.

* * *

>w
You move toward the open ridge, but before you can step into the light, Xilar's hand closes firmly around your arm.

"Not yet. They are still searching the crash site. If they see us now, they will follow us straight back to the camp."

He draws you back into the shadow of the rocks. You return to the Observation Rock.

[Your score has just gone up by three points.]

>w
You move toward the open ridge, but before you can step into the light, Xilar's hand closes firmly around your arm.

"Not yet. They are still searching the crash site. If they see us now, they will follow us straight back to the camp."

He draws you back into the shadow of the rocks. You return to the Observation Rock.

>w
You move toward the open ridge, but before you can step into the light, Xilar's hand closes firmly around your arm.

"Not yet. They are still searching the crash site. If they see us now, they will follow us straight back to the camp."

He draws you back into the shadow of the rocks. You return to the Observation Rock.

>return to obervation rock
That's not a verb I recognise.

>return
That's not a verb I recognise.

>go bakc
You can't see any such thing.

>go bac
You can't see any such thing.

>go back
You can't see any such thing.

>g
You can't see any such thing.

>undo
Observation Rock
[Previous turn undone.]

>examine
What do you want to examine?

>location
You can't see any such thing.

>observation rock
That's not a verb I recognise.

>examine
What do you want to examine?

>obervation rock
You can't see any such thing.

>w
You move toward the open ridge, but before you can step into the light, Xilar's hand closes firmly around your arm.

"Not yet. They are still searching the crash site. If they see us now, they will follow us straight back to the camp."

He draws you back into the shadow of the rocks. You return to the Observation Rock.

>e
Bioluminescent Forest
A vast forest where every plant pulses with soft blue and green light. Bioluminescent spores drift like slow snow between towering trees, and the air hums with quiet, ancient life.

A massive fallen tree blocks the northern path to the Ghanrion Camp. To the EAST the ground drops away toward the Ravine, and to the WEST a rocky path climbs toward the Observation Rock.

You can see Xilar and Zarb here.

>talk to xilar
Xilar nods with quiet, steady gratitude.

"I owe you a debt I will not forget. These forests hold no secrets from me. The fallen tree across the north path is no obstacle -- I know every hidden trail. Walk with me and I will guide you safely to the camp."

He glances north. "You can go NORTH now from the forest."

>n
Ghanrion Camp
A living settlement woven among ancient trees. Bioluminescent lanterns sway between branches, casting the settlement in warm, shifting light. The elder Vael moves with quiet authority between the shelters.

To the SOUTH lies the Bioluminescent Forest.

You can see Vael here.

>talk to vael
Vael's expression is grave but utterly composed.

"There is no more time for words. The soldiers are here. You must decide what kind of person you are."

He meets your eyes steadily.

Your three choices are:

  HELP VAEL -- Stand beside the elder and face the soldiers together.

  GUIDE YOUNG -- Lead the children and elders through the hidden tunnels to safety.

  OBSERVE -- Pull back into the shadows and bear witness.

>guide young
You move quickly and without a word, gathering the young Ghanrion with calm, urgent gestures. Through the tunnels beneath the Ravine -- tunnels you now know well -- you lead them in single file through the glowing dark.

Behind you, voices rise. Tense and confused. But no pursuit comes.

The children emerge into the far forest, blinking in the cold air. One of the youngest looks back at you, her luminescent eyes wide and full of something that might be gratitude, or wonder, or both.

Above ground, the standoff continues. You have saved some. The rest remains unwritten.

    *** Partial Escape -- The young were saved. The fate of the camp is still unwritten. Perhaps that is enough for now. ***

In that game you scored 16 out of a possible 20, in 23 turns.

Would you like to RESTART, RESTORE a saved game, QUIT or UNDO the last command?

>undo
Ghanrion Camp
[Previous turn undone.]

>e
You can't go that way.

>n
You can't go that way.

>w
You can't go that way.

* * *

>s
Bioluminescent Forest
A vast forest where every plant pulses with soft blue and green light. Bioluminescent spores drift like slow snow between towering trees, and the air hums with quiet, ancient life.

A massive fallen tree blocks the northern path to the Ghanrion Camp. To the EAST the ground drops away toward the Ravine, and to the WEST a rocky path climbs toward the Observation Rock.

You can see Xilar and Zarb here.

>talk to zarb
Zarb communicates through a series of soft bioluminescent pulses and deliberate gestures. Somehow, you understand every word.

"Something fell from the sky -- to the west. It burns, and it brought soldiers with it. They will push deeper into the forest. We must warn the camp, but the elder will not act on my word alone. Xilar carries the elder's trust."

He pauses, his skin flickering with anxious light.

"Xilar was scouting the Ravine when the debris came down on him. Please -- free him first. Go EAST to find him. Type HELP XILAR when you reach him."

>use telephaty
I didn't understand that sentence.

>USE TELEPATHY
You close your eyes and push a weak telepathic signal outward through the forest network.

For a moment, nothing. Then a tremor moves through the bioluminescent light all around you -- the plants respond like a living relay, carrying your signal through root and spore and branch.

Zarb spins toward you, eyes wide.

"You... you sent that?" His skin flashes bright white with shock.

The forest hums softly in reply.

[Your score has just gone up by two points.]

>e
Ravine
A deep, rocky ravine. The walls are jagged and the air is cold and damp. Somewhere beneath the fallen debris you can hear faint, pained breathing.

To the WEST the glow of the forest beckons. Below you, darkness hints at underground tunnels -- go DOWN to explore them.

* * *

>w
Bioluminescent Forest
A vast forest where every plant pulses with soft blue and green light. Bioluminescent spores drift like slow snow between towering trees, and the air hums with quiet, ancient life.

A massive fallen tree blocks the northern path to the Ghanrion Camp. To the EAST the ground drops away toward the Ravine, and to the WEST a rocky path climbs toward the Observation Rock.

You can see Xilar and Zarb here.

>help xilar
Xilar is already free. He is ready to guide you north.

>n
Ghanrion Camp
A living settlement woven among ancient trees. Bioluminescent lanterns sway between branches, casting the settlement in warm, shifting light. The elder Vael moves with quiet authority between the shelters.

To the SOUTH lies the Bioluminescent Forest.

You can see Vael here.

>help vael
You walk forward and stand beside Vael.

The soldiers freeze.

Something about the image -- the ancient elder and a being they cannot categorise, standing together without weapons, without aggression, without fear -- fractures their certainty. Training accounts for hostility. It does not account for this.

A long silence stretches across the camp. The wind moves through the luminescent leaves.

Slowly, one soldier lowers his weapon. Then another. Then all of them.

Vael places a hand on your shoulder and says nothing. He does not need to.

Behind you, the camp exhales.

    *** A Fragile Peace -- You stood with the Ghanrion and turned fear into stillness. The first step toward understanding has been taken. ***

In that game you scored 20 out of a possible 20, in 33 turns.

Would you like to RESTART, RESTORE a saved game, QUIT or UNDO the last command?

>undo
Ghanrion Camp
[Previous turn undone.]

* * *

>n
You can't go that way.

>e
You can't go that way.

* * *

>n
You can't go that way.

>up
You can't go that way.

>w
You can't go that way.

>n
You can't go that way.

* * *

>e
You can't go that way.

>w
You can't go that way.

* * *

>w
Observation Rock
A high cliff with a sweeping view of the entire forest. The bioluminescent canopy stretches endlessly to the east and north. To the WEST, a column of black smoke rises against the sky -- something has crashed on your world.

To the EAST, the path descends back into the forest.

>w
You move toward the open ridge, but before you can step into the light, Xilar's hand closes firmly around your arm.

"Not yet. They are still searching the crash site. If they see us now, they will follow us straight back to the camp."

He draws you back into the shadow of the rocks. You return to the Observation Rock.